a-t-il	vouloir
affiche 	vouloir
aimerais	vouloir
articles 	article
auteurs	auteur
Combien	combien
concernant	parler
contenant	parler
contient 	parler
donne 	vouloir
Donne	vouloir
Donne-moi	vouloir
Donnez	vouloir
Donnez-moi	vouloir
écrit	auteur
en	date
Focus	focus
par	auteur
parle 	parler
parlant	parler
parlent 	parler
portant	parler
possédant	parler
Quand	date
Quel	vouloir
quel	vouloir
Quelle	vouloir
quelle	vouloir
Quelles	vouloir
quelles	vouloir
Quels	vouloir
quels	vouloir
réference	parler
Retourner	vouloir
rubriques 	rubrique
souhaiterais	vouloir
titres 	titre
traitant	parler
traite 	parler
traitent 	parler
Une	une
UNEs	une
unes	une
veux 	vouloir
voudrais 	vouloir
Y-a-t-il	vouloir