a-t-il	vouloir
adresses	auteur
affiche 	vouloir
afp	afp
aimerais	vouloir
articlent	article
articles 	article
auteurs	auteur
concernant	parler
contenant	parler
contient 	parler
domaine	email
donne 	vouloir
donne-moi	vouloir
donnez	vouloir
donnez-moi	vouloir
écrit	auteur
évoque	parler
on	parler
ont	parler
par	auteur
parle 	parler
parlé	parler
parlant	parler
parlent 	parler
portant	parler
porte	parler
possédant	parler
quand	date
quel	vouloir
quelle	vouloir
quelles	vouloir
quels	vouloir
réference	parler
référence	parler
retourner	vouloir
rubriques 	rubrique
souhaiterais	vouloir
titres 	titre
traitant	parler
traite 	parler
traitent 	parler
unes	une
veux 	vouloir
voudrais 	vouloir
y-a-t-il	vouloir